1111111111111111111111111111111111111
1000000000000000000000100000100000001
1011111111111110111110101011101111101
1000001000100010100010101010001000001
1111101110101010101010101010111011101
1000001000101010101000101010001000101
1011111011101010111011101111101110101
1000000010001010001000100000001000101
1111111010111011101110101111111011101
1000100010001010001010101000100010101
1011101111101010111010111010101110101
1010001000101000100010100010001010001
1010111010101111101010101111111010111
1000100010100010001000101000001000101
1011111011111011111011101011101011101
1000000015001000001000001010001010001
1111111111101110101111111010111011101
1000100000100010100010001010001000001
1010101110111010111010101011111111101
1010001010000010100010101000001000101
1011111011111111101010101011101010101
1010000000001000001010101000100010101
1011111110111010111110101110111110101
1010001000100010000000101000100010001
1010101010101111111111101110101011111
1010101010101000100000100010001000101
1010101011101010111010111011111110101
1010101000100010000010001000000010001
1010101010111111111011111111111011101
1010101010000000000010000000001010001
1010101111111110111110111111101011101
1000100000000010001000101000001000101
1111111111111011111011101011111010101
1000000010001010000010100010000010101
1010111110101010111110101111111110101
1010000000100000100000000000000000101
1111111111111111111111111111111111171
