1111111111111111111111111111111111111
1000000000000003333333100000100000001
1011111111111113111113101011101111101
1000001000133313100013101010001333331
1111101110131313101013101010111311131
1000001000131313101333101010001333131
1011111011131313111311101111101113131
1000000013331313331333100000001333131
1111111013111311131113101111111311131
1000100013331313331013101333133310131
1011101111131313111013111313131110131
1010001000131333100013133313331013331
1010111010131111101013131111111013111
1000100010133310001333131000001333101
1011111011111311111311131011101311101
1000000015331333331333331010001310001
1111111111131110131111111010111311101
1333133333133310133313331010001333331
1313131113111310111313131011111111131
1313331013333310133313131333331333131
1311111011111111131013131311131313131
1310000000001003331013131333133313131
1311111110111013111113131113111113131
1313331000100013333333131003133313331
1313131010101111111111131113131311111
1313131010101000100000133313331333101
1313131011101010111010111311111113101
1313131000100010000010001333333313331
1313131010111111111011111111111311131
1313131010000000000013333333331310031
1313131111111110111113111111131311131
1333133333333310001333101333331333131
1111111111111311111311101311111013131
1000000010001313333310133310000013131
1010111110101313111110131111111113131
1010000000100333100000033333333333131
1111111111111111111111111111111111171
